C 104,17,17
F 84,84,84

NO ./assets/lavawall1.xpm
SO ./assets/lavawall4.xpm
EA ./assets/lavawall2.xpm
WE ./assets/lavawall3.xpm

111111111111111111111111
11000S000000000000000001
100000000000000000000001
100011111111110000000001
100000000000000000000001
100000100000000000000001
100000100000000000000001
100000101110000000000001
100000100000010000000001
100000100000010000000001
100000100100010000000001
100000100100010111111001
100000100000010000000001
100000100000010000000001
100000000000000000000001
100000010000000000000001
100000010011001000000001
100011111110001000000001
100010000000000000000001
100010000000000111000001
100010000000000001000001
100000000000000111110001
100000000000000000000001
111111111111111111111111