        1111111111111111111111111
111111111000000001111111101111111
        1011000001000110000000011
        1001003001000110003000011
111111111011000000000110000000011
100000000011003000300000300111111
11110000000000000000000000001
11110111111110000000000000001
1100001     10011100000200401
10040011111110001100000200001
10000000000000000000000201411
11000000110101011111000000E0111
11110001 1110101 101000000001
11111111 1111111 111111111111
