NO                       ./1
EA         ./2
C      100,2,15
WE         ./3
SO         ./4
F      0,0,255

        1111111111111111111111111
        1000100000110000000000001
        1011000001110000000000001
        1001000000000000001000001
111111111011000001110000000000001
100000100011000111110111110111111
11110111111111010000000010001
11110111111111010101010011001
11010101010101000000000010001
10000000000000000001010000001
1001010101010100110001101011111111
110101011101010111110111100N000001
11110111 1110101 10111100000111111
11111111 1111111 111111111111