111111111111111111111111111111111111111111111
1E0000000000000C00000C0000000000000C000C000C1
101001010010000010100100000001010CC000C00C001
101001001010101000100100000001010000C00000001
1P0000000C00C0000000000000000000C0000C00000C1
111111111111111111111111111111111111111111111