1111111111111111111111111111111111111111111111111111111111111111111111111111111111111111111111111111
10000000000000000000000000000000000000000000000000000000000000000000000000000000000000000000000000E1
1011000001100011100000000000000000000000000000000000000000000000000000000000000000000000000000000001
1010100010100100010000000000000000000000000000000000000000000000000000000000000000000000000000000001
1010010100101000001000000000000000000000000000000000000000000000000000000000000000000000000000000001
1010001000101000001000000000000000000000000000000000000000000000000000000000000000000000000000000001
1010000000101000001000000000000000000000000000000000000000000000000000000000000000000000000000000001
1010000000100100010000000000000000000000000000000000000000000000000000000000000000000000000000000001
1010000000100011100000000000000000000000000000000000000000000000000000000000000000000000000000000001
1P000000000000000000000000000000000000000000000000000000000000000000000000000000000000000000000000C1
1111111111111111111111111111111111111111111111111111111111111111111111111111111111111111111111111111