1111111111111111111111
1010001011101110101111
10101P1111111111111011
100000000000000F001111
1011101011111010111011
1111111011101010001011
1000111011111010111011
1010101011111110101011
1110111010001010111011
1000C00C101010000F00E1
1111111111111111111111