1111111111111111111111111111111111111111111111
1E10P0101110111010110000000000000000000000E011
101010111111111111100010C000011111110110000011
10C0000000C000000011000100000000C0000110000011
1011101011111010111000001000000000000110000011
1111111011101010001000000100000100111111100011
1000111011111010111000000010000100000000000C11
101010101111111010100001111110010C001100000011
11101110100C0010111000000010000C00001100110011
1000C00C10101C0000000C0000100000000011000E0011
1111111111111111111111111111111111111111111111