1111111111111111111111111111
1E0010P000000000000000000001
100011111111100000C000000001
100000000001110C0000C1111001
100011110C0000011000C0000001
100C00000000000C000000000001
1111111111111111111111111111